“一带一路”	the Belt and Road Initiative|the Belt and Road|Belt and Road
“一带一路”倡议	the Belt and Road Initiative
墨子	Mozi
抵近侦察	close-in reconnaissance
北斗卫星导航系统	BeiDou Navigation Satellite System|BDS
物联网	Internet of Things (IoT)|Internet of Things|IoT
大数据	big data
云计算	cloud computing
和平发展	peaceful development
国防	national defense
领海	territorial waters
领土问题	disputes over territory
国家安全	national security
国土安全	homeland security
社会稳定	social stability
反恐	counter-terrorism|Anti-Terrorism|counter terrorism|fight against terrorism|fight terrorism|against terrorism|terrorism|counterterrorism
去极端化	Anti-extremism|combat extremism|deradicalization|de-radicalization|extremism
4•26决定	April 26 Decision
8•31决定	August 31 Decision
爱国	patriotic|patriotism|love the country
爱国主义	patriotism
国际发展合作	international development cooperation
南南合作	South-South cooperation
南北合作	North-South cooperation
特困人员	people living in extreme poverty|people in extreme poverty|severely impoverished people|residents in extreme difficulty|people living in dire poverty|the extremely poor|people in extreme difficulty|severely impoverished
五保	five guarantees
中国科学院	the Chinese Academy of Sciences (CAS)|the Chinese Academy of Sciences|CAS
三方合作	tripartite cooperation
天人合一	unity of man and nature|Man is an integral part of nature
道法自然	Tao follows nature|Dao follows the laws of nature
国家卫生健康委	the National Health Commission (NHC)|NHC|the National Health Commission
中国疾控中心	The Chinese Center for Disease Control and Prevention (China CDC)|China CDC|The Chinese Center for Disease Control and Prevention|the CDC
溯源	trace the origin|determine its origin|virus traceability
柳叶刀	the Lancet
谭德塞	Tedros Adhanom Ghebreyesus
二十国集团	G20
新型冠状病毒	new coronavirus|the Covid-19|novel coronavirus
世界卫生组织	the WHO|the World Health Organization (WHO)|the World Health Organization|WHO
欧盟	the European Union|the EU
爱好	hobby
民法典	the Civil Code
安全	security
协商民主	consultative democracy|democratic consultation
求同存异	seeking common ground while setting aside differences
地球村	a global village
人民民主专政	the people's democratic dictatorship
合作共赢	win-win cooperation
人类命运共同体	a global community of shared future|a community with a shared future
埃博拉	Ebola
江格尔	Jangar
多边主义	multilateralism
黄热病	yellow fever
寨卡	Zika
榜样	example|good examples|model|role model
北京	Beijing|Peking
北京市	Beijing
本科	undergraduate course
比利时	Belgium
必由之路	the only path|a must
毕业	graduation
标准	criterion
表彰	award|honored
波茨坦公告	the Potsdam Proclamation
博物馆	Museum
不扩散核武器条约	the Treaty on the Non-Proliferation of Nuclear Weapons (NPT)|NPT
才华	intellectual brilliance
供给侧结构性改革	supply-side structural reform
中国残联	the China Disabled Persons' Federation (CDPF)|the China Disabled Persons' Federation|CDPF
才能	ability
中小微企业	micro, small and medium enterprises|micro, small and medium-sized enterprises
中小企业	small and medium enterprises|small and medium-sized enterprises
京津冀协同发展	the coordinated development of the Beijing-Tianjin-Hebei Region
粤港澳大湾区	the Guangdong-Hong Kong-Macao Greater Bay Area
导盲犬 guide dogs
长江经济带	the Yangtze River Economic Belt
青藏公路	 the Qinghai-Tibet Highway
残疾	disabilities
张海迪	Zhang Haidi
残疾人	people with disabilities|persons with disabilities|with disabilities|disabled persons
产学研	industries, universities, and research institutes|enterprises, universities, and research institutes|industries, universities, researchers
常委会	the Standing Committee|Standing Committee
嫦娥	Chang'e
潮流	the trend
两不愁三保障	the Two Assurances and Three Guarantees
脱贫攻坚	poverty eradication|poverty elimination|campaign against poverty|battle against poverty|eliminate absolute poverty|poverty alleviation|fight against poverty|reduce poverty|eradicate absolute poverty|poverty-alleviation
国家粮食安全战略	national strategies for food security
乡村振兴战略	the rural revitalization strategy
人居环境	living environment|environment
多党合作	multiparty cooperation
政治协商	political consultation
健康中国	the Healthy China initiative|Healthy China
成就	accomplishment|achievement|attainment|success|stride
初中	junior high school|junior middle school|junior secondary school
创新	innovative
创新驱动	innovation-driven
创新型	innovative
创业	entrepreneurship
创造性	creativity
大学	college|university
大中小学	elementary and secondary schools and universities|primary, secondary, and higher education|secondary and primary schools and universities|primary and secondary schools and institutions of higher education
待遇	remuneration|pay package|treatment|wellbeing
当家作主	be the masters
党委	CPC committee|Party committee|CPC committees|Party committees
党员	Party members
党员干部	Party officials
党中央	the CPC Central Committee
道德	moral integrity|moral|ethics|virtue
邓小平	Deng Xiaoping
地球村	a global village|the global village
对外开放	opening up|openness|open| open up to the outside world
发展中国家	developing country
繁荣	prosperity|prosperous
反对派	opponents
反分裂国家法	the Anti-Secession Law
反华势力	anti-China forces
分裂主义	separatism
腐败	corruption
复工复产	economic reopening|resuming economic activity|resume operations
改革开放	reform and opening up
感召	appeal
感召力	appeal
高等教育	higher education
高等学校	higher education institutions
高度自治	a high degree of autonomy
高素质	high-caliber
各族人民	people of all ethnic groups
根本	fundamental
公平正义	equity and justice
共产党	Communist Party
共产党人	communists
共产党员	party members
共产主义	communism
共青团	Communist Youth League
共同体	community
国务院	the State Council
国有企业	state-owned enterprise
行政长官	the Chief Executive|Chief Executive
和平统一	peaceful reunification
后疫情时代	the post-pandemic era
胡锦涛	Hu Jintao
基层	at the grassroots level
基础教育	basic education
江泽民	Jiang Zemin
交流合作	exchanges and cooperation
教师	teacher
教育	education
金砖国家	BRICS countries
敬业	dedication
九二共识	the 1992 Consensus
就业	employment
开罗宣言	the Cairo Declaration
科教兴国	revitalizing the country through science and education|invigorating China through 
科教兴国	revitalizing the country through science and education|invigorating China through science and education
可持续发展	Sustainable Development|sustainable development
联合国教科文组织	the UNESCO
孔子课堂	Confucius Classrooms
孔子学院	Confucius Institutes
联合国	the United Nations|the UN|UN
联合国宪章	the UN Charter
两岸关系	cross-Straits relations
两个一百年	Two Centenary
列宁	Lenin
零容忍	zero-tolerance
领土完整	territorial integrity
马克思	Marx|Carl Marx
马克思主义	Marxism
马克思主义者	Marxist
毛泽东	Mao Zedong
民主集中制	democratic centralism
民族复兴	national rejuvenation|rejuvenate China|rejuvenation
民族振兴	national rejuvenation|rejuvenate China|rejuvenation
澎湖列岛	the Penghu Islands
企业	enterprises
强国	power|powerhouse|rejuvenate the country
区域协调发展	coordinated regional development
全国各族人民	people of all ethnic groups|the Chinese nation
全国人大	National People's Congress
全过程人民民主	whole-process people's democracy
人才	competent personnel|quality workforce|talent
人才培养	talent training|talent cultivation
人工智能	artificial intelligence|AI
人民政府	governments
人文交流	people-to-people and cultural exchanges
认同	identity
认同感	sense of identity
社会主义核心价值观	core socialist values
社会主义现代化	socialist modernization
师生	teachers and students
十八大	the 18th CPC National Congress|the 18th National Congress
使命	mission
使命感	sense of mission
世界	world
世界观	worldview
市场	market
市场经济	market economy
数字经济	digital economy
丝绸之路	Silk Road
思想基础	the ideological foundation
四个全面	the Four-Pronged Comprehensive Strategy
天宫空间站	Tiangong space station
脱贫	poverty alleviation|out of poverty|reduce poverty
网络空间命运共同体	community with a shared future in cyberspace
文明	civilization
五四运动	the May Fourth Movement|the May 4th Movement
无党派人士	non-affiliates
人大代表	deputies to people's congresses
政协委员	members of CPPCC committees
统一战线	the united front
全国工商联	the All-China Federation of Industry and Commerce
坚持四项基本原则	adhering to the Four Cardinal Principles – to keep to the path of socialism, to uphold the people's democratic dictatorship, to uphold the leadership of the CPC, and to uphold Marxism-Leninism and Mao Zedong Thought
俄国十月革命	the October Revolution in Russia
新民主主义革命	the New Democratic Revolution
五位一体	the Five-Sphere Integrated Plan
五中全会	the Fifth Plenary Session
希望工程	Project Hope
习近平	Xi Jinping|Xi
宪法	the Constitution
宪法	the Constitution
乡村振兴	the rural revitalization
香港特别行政区	The Hong Kong Special Administrative Region (HKSAR)|Hong Kong|The Hong Kong Special Administrative Region|the HKSAR|HKSAR
小康社会	a moderately prosperous society
新冠肺炎疫情	the Covid-19 pandemic|Covid-19
新时代	New Era
修例风波	the 2019 turmoil
学前教育	pre-school education|preschool education
初等教育	primary education
中等教育	secondary education
九三学社	the Jiusan Society
民革	the Revolutionary Committee of the Chinese Kuomintang
民盟	the China Democratic League
民建	the China National Democratic Construction Association
民进	the China Association for Promoting Democracy
农工党	the Chinese Peasants and Workers Democratic Party
致公党	the China Zhi Gong Party
国际社会	the international community
美丽中国	the Beautiful China initiative|Beautiful China
绿水青山就是金山银山	lucid waters and lush mountains are invaluable assets
台盟	the Taiwan Democratic Self-Government League
国际刑警组织	the International Criminal Police Organization
博鳌亚洲论坛	Boao Forum for Asia
上海合作组织	the Shanghai Cooperation Organization (SCO)|the Shanghai Cooperation Organization|SCO
东盟地区论坛	ASEAN Regional Forum
香山论坛	the Xiangshan Forum|Beijing Xiangshan Forum
东盟	ASEAN
阿盟	the League of Arab States
中国－东盟博览会	China-ASEAN Expo
世界经济论坛	the World Economy Forum (WEF)|the World Economy Forum|WEF
步兵营	the infantry battalions
保护平民	The Protection of Civilians (POC)|POC
学生	student
维和行动	peacekeeping operations|peacekeeping missions|the UNPKOs|peacekeeping
生态文明	eco-civilization
自然保护地	protected areas (PAs)|PA|PAs
生物多样性	biodiversity|biological diversity|biodiverse
和谐共生	live in harmony|coexist in harmony|harmony between|harmonious coexistence|
亚太地区	the Asia-Pacific
一带一路	the Belt and Road Initiative|the Belt and Road|Belt and Road
一个中国原则	the one-China principle
一国两制	One Country, Two Systems|the Two Systems solution
依法治国	law-based governance|governace is based in law|the rule of law
义务教育	compulsory education|compulsory schooling
责任感	sense of responsibility
长治久安	the long-term stability
招生	admission|advertising for students|student recruitment
真善美	the true, the good, and the beautiful
政府	governments
政治局	the Political Bureau
知识分子	intellectuals|talents
职业教育	technical and vocational education
智库	think tanks
中非合作论坛	the Forum on China-Africa Cooperation (FOCAC)|FOCAC
中共中央	the CPC Central Committee
中共中央政治局	the Political Bureau of the CPC Central Committee
中国共产党	the Communist Party of China|the CPC
中国国情	national conditions|the conditions in China|China's national conditions|China's realities
中国梦	the Chinese Dream|Chinese Dream
中国特色社会主义	socialism with Chinese characteristics
中华民族伟大复兴	national rejuvenation|rejuvenation
中华人民共和国	the People's Republic of China|PRC
中华优秀传统文化	the best of traditional Chinese culture|fine traditional Chinese culture|
中华优秀传统文化	the best of traditional Chinese culture|fine traditional Chinese culture|traditional Chinese culture|China's splendid cultural heritage|China's great tradition|China's tradition
中美建交公报	the China-US Joint Communique on the Establishment of Diplomatic Relations
中央政府	the Chinese government|the central government|Chinese government|the central government of China
主力军	the main force
主权	sovereignty
主心骨	backbone
主要矛盾	the principal challenge
资本	capital
资本主义	capitalist
综合国力	overall national strength
总书记	General Secretary
尊严	dignity